ACCESS:                       A C C E S S;
ADD:                          A D D;
AFTER:                        A F T E R;
AGENT:                        A G E N T;
AGGREGATE:                    A G G R E G A T E;
ALL:                          A L L;
ALTER:                        A L T E R;
ANALYZE:                      A N A L Y Z E;
AND:                          A N D;
ANY:                          A N Y;
ARRAY:                        A R R A Y;
ARROW:                        A R R O W;
AS:                           A S;
ASC:                          A S C;
ASSOCIATE:                    A S S O C I A T E;
ASSOCIATION_OPERATOR:         '=>';
AT:                           A T;
ATTRIBUTE:                    A T T R I B U T E;
AUDIT:                        A U D I T;
AUTHID:                       A U T H I D;
AUTO:                         A U T O;
AUTOMATIC:                    A U T O M A T I C;
AUTONOMOUS_TRANSACTION:       A U T O N O M O U S '_' T R A N S A C T I O N;
AVG:                          A V G;
A_LETTER:                     A;
BATCH:                        B A T C H;
BEFORE:                       B E F O R E;
BEGIN:                        B E G I N;
BETWEEN:                      B E T W E E N;
BFILE:                        B F I L E;
BFILE_BASE:                   B F I L E '_' B A S E;
BINARY:                       B I N A R Y;
BINARY_DOUBLE:                B I N A R Y '_' D O U B L E;
BINARY_FLOAT:                 B I N A R Y '_' F L O A T;
BINARY_INTEGER:               B I N A R Y '_' I N T E G E R;
BLOB:                         B L O B;
BLOB_BASE:                    B L O B '_' B A S E;
BLOCK:                        B L O C K;
BODY:                         B O D Y;
BOOLEAN:                      B O O L E A N;
BOTH:                         B O T H;
BOUND:                        B O U N D;
BREADTH:                      B R E A D T H;
BULK:                         B U L K;
BY:                           B Y;
BYTE:                         B Y T E;
CACHE:                        C A C H E;
CALL:                         C A L L;
CALLING:                      C A L L I N G;
CANONICAL:                    C A N O N I C A L;
CASCADE:                      C A S C A D E;
CASE:                         C A S E;
CAST:                         C A S T;
CHAR:                         C H A R;
CHARACTER:                    C H A R A C T E R;
CHARSET:                      C H A R S E T;
CHARSETFORM:                  C H A R S E T F O R M;
CHARSETID:                    C H A R S E T I D;
CHAR_BASE:                    C H A R '_' B A S E;
CHAR_CS:                      C H A R '_' C S;
CHECK:                        C H E C K;
CHR:                          C H R;
CLOB:                         C L O B;
CLOB_BASE:                    C L O B '_' B A S E;
CLOSE:                        C L O S E;
CLUSTER:                      C L U S T E R;
CLUSTERS:                     C L U S T E R S;
COLAUTH:                      C O L A U T H;
COLLECT:                      C O L L E C T;
COLUMN:                       C O L U M N;
COLUMNS:                      C O L U M N S;
COLUMN_VALUE:                 C O L U M N '_' V A L U E;
COMMENT:                      C O M M E N T;
COMMIT:                       C O M M I T;
COMMITTED:                    C O M M I T T E D;
COMPATIBILITY:                C O M P A T I B I L I T Y;
COMPILE:                      C O M P I L E;
COMPILED:                     C O M P I L E D;
COMPOUND:                     C O M P O U N D;
COMPRESS:                     C O M P R E S S;
CONNECT:                      C O N N E C T;
CONNECT_BY_ROOT:              C O N N E C T '_' B Y '_' R O O T;
CONSTANT:                     C O N S T A N T;
CONSTRAINT:                   C O N S T R A I N T;
CONSTRAINTS:                  C O N S T R A I N T S;
CONSTRUCTOR:                  C O N S T R U C T O R;
CONTENT:                      C O N T E N T;
CONTEXT:                      C O N T E X T;
CONTINUE:                     C O N T I N U E;
CONVERT:                      C O N V E R T;
CORR:                         C O R R;
CORRUPT_XID:                  C O R R U P T '_' X I D;
CORRUPT_XID_ALL:              C O R R U P T '_' X I D '_' A L L;
COST:                         C O S T;
COUNT:                        C O U N T;
COVAR_:                       C O V A R '_';
CRASH:                        C R A S H;
CREATE:                       C R E A T E;
CROSS:                        C R O S S;
CUBE:                         C U B E;
CUME_DIST:                    C U M E '_' D I S T;
CURRENT:                      C U R R E N T;
CURRENT_USER:                 C U R R E N T '_' U S E R;
CURSOR:                       C U R S O R;
CUSTOMDATUM:                  C U S T O M D A T U M;
CYCLE:                        C Y C L E;
C_LETTER:                     C;
DANGLING:                     D A N G L I N G;
DATA:                         D A T A;
DATABASE:                     D A T A B A S E;
DATE:                         D A T E;
DATE_BASE:                    D A T E '_' B A S E;
DAY:                          D A Y;
DBTIMEZONE:                   D B T I M E Z O N E;
DB_ROLE_CHANGE:               D B '_' R O L E '_' C H A N G E;
DDL:                          D D L;
DEBUG:                        D E B U G;
DEC:                          D E C;
DECIMAL:                      D E C I M A L;
DECLARE:                      D E C L A R E;
DECOMPOSE:                    D E C O M P O S E;
DECREMENT:                    D E C R E M E N T;
DEFAULT:                      D E F A U L T;
DEFAULTS:                     D E F A U L T S;
DEFERRED:                     D E F E R R E D;
DEFINE:                       D E F I N E;
DEFINER:                      D E F I N E R;
DELETE:                       D E L E T E;
DENSE_RANK:                   D E N S E '_' R A N K;
DEPTH:                        D E P T H;
DESC:                         D E S C;
DETERMINISTIC:                D E T E R M I N I S T I C;
DIMENSION:                    D I M E N S I O N;
DISABLE:                      D I S A B L E;
DISASSOCIATE:                 D I S A S S O C I A T E;
DISTINCT:                     D I S T I N C T;
DOCUMENT:                     D O C U M E N T;
DOUBLE:                       D O U B L E;
DROP:                         D R O P;
DSINTERVAL_UNCONSTRAINED:     D S I N T E R V A L '_' U N C O N S T R A I N E D;
DURATION:                     D U R A T I O N;
EACH:                         E A C H;
ELEMENT:                      E L E M E N T;
ELSE:                         E L S E;
ELSIF:                        E L S I F;
EMPTY:                        E M P T Y;
ENABLE:                       E N A B L E;
ENCODING:                     E N C O D I N G;
END:                          E N D;
ENTITYESCAPING:               E N T I T Y E S C A P I N G;
ERRORS:                       E R R O R S;
ESCAPE:                       E S C A P E;
EVALNAME:                     E V A L N A M E;
EXCEPT:                       E X C E P T;
EXCEPTION:                    E X C E P T I O N;
EXCEPTIONS:                   E X C E P T I O N S;
EXCEPTION_INIT:               E X C E P T I O N '_' I N I T;
EXCLUDE:                      E X C L U D E;
EXCLUSIVE:                    E X C L U S I V E;
EXECUTE:                      E X E C U T E;
EXISTS:                       E X I S T S;
EXIT:                         E X I T;
EXPLAIN:                      E X P L A I N;
EXTEND:                       E X T E N D;
EXTERNAL:                     E X T E R N A L;
EXTRACT:                      E X T R A C T;
FAILURE:                      F A I L U R E;
FALSE:                        F A L S E;
FETCH:                        F E T C H;
FILE:                         F I L E;
FINAL:                        F I N A L;
FIRST:                        F I R S T;
FIRST_VALUE:                  F I R S T '_' V A L U E;
FIXED:                        F I X E D;
FLOAT:                        F L O A T;
FOLLOWING:                    F O L L O W I N G;
FOLLOWS:                      F O L L O W S;
FOR:                          F O R;
FORALL:                       F O R A L L;
FORCE:                        F O R C E;
FORM:                         F O R M;
FROM:                         F R O M;
FULL:                         F U L L;
FUNCTION:                     F U N C T I O N;
GENERAL:                      G E N E R A L;
GOTO:                         G O T O;
GRANT:                        G R A N T;
GROUP:                        G R O U P;
GROUPING:                     G R O U P I N G;
HASH:                         H A S H;
HAVING:                       H A V I N G;
HEAP:                         H E A P;
HIDDEN:                       H I D D E N;
HIDE:                         H I D E;
HOUR:                         H O U R;
IDENTIFIED:                   I D E N T I F I E D;
IF:                           I F;
IGNORE:                       I G N O R E;
IMMEDIATE:                    I M M E D I A T E;
IN:                           I N;
INCLUDE:                      I N C L U D E;
INCLUDING:                    I N C L U D I N G;
INCREMENT:                    I N C R E M E N T;
INDENT:                       I N D E N T;
INDEX:                        I N D E X;
INDEXED:                      I N D E X E D;
INDEXES:                      I N D E X E S;
INDICATOR:                    I N D I C A T O R;
INDICES:                      I N D I C E S;
INFINITE:                     I N F I N I T E;
INITIAL:                      I N I T I A L;
INLINE:                       I N L I N E;
INNER:                        I N N E R;
INOUT:                        I N O U T;
INSERT:                       I N S E R T;
INSTANTIABLE:                 I N S T A N T I A B L E;
INSTEAD:                      I N S T E A D;
INT:                          I N T;
INTEGER:                      I N T E G E R;
INTERFACE:                    I N T E R F A C E;
INTERSECT:                    I N T E R S E C T;
INTERVAL:                     I N T E R V A L;
INTO:                         I N T O;
INVALIDATE:                   I N V A L I D A T E;
IS:                           I S;
ISOLATION:                    I S O L A T I O N;
ITERATE:                      I T E R A T E;
JAVA:                         J A V A;
JOIN:                         J O I N;
KEEP:                         K E E P;
LAG:                          L A G;
LANGUAGE:                     L A N G U A G E;
LARGE:                        L A R G E;
LAST:                         L A S T;
LAST_VALUE:                   L A S T '_' V A L U E;
LEAD:                         L E A D;
LEADING:                      L E A D I N G;
LEFT:                         L E F T;
LENGTH:                       L E N G T H;
LEVEL:                        L E V E L;
LIBRARY:                      L I B R A R Y;
LIKE2:                        L I K E '2';
LIKE4:                        L I K E '4';
LIKE:                         L I K E;
LIKEC:                        L I K E C;
LIMIT:                        L I M I T;
LIMITED:                      L I M I T E D;
LISTAGG:                      L I S T A G G;
LOCAL:                        L O C A L;
LOCK:                         L O C K;
LOCKED:                       L O C K E D;
LOG:                          L O G;
LOGOFF:                       L O G O F F;
LOGON:                        L O G O N;
LONG:                         L O N G;
LOOP:                         L O O P;
MAIN:                         M A I N;
MAP:                          M A P;
MATCHED:                      M A T C H E D;
MAX:                          M A X;
MAXEXTENTS:                   M A X E X T E N T S;
MAXLEN:                       M A X L E N;
MAXVALUE:                     M A X V A L U E;
MEASURES:                     M E A S U R E S;
MEDIAN:                       M E D I A N;
MEMBER:                       M E M B E R;
MERGE:                        M E R G E;
MIN:                          M I N;
MINUS:                        M I N U S;
MINUTE:                       M I N U T E;
MINVALUE:                     M I N V A L U E;
MLSLABEL:                     M L S L A B E L;
MOD:                          M O D;
MODE:                         M O D E;
MODEL:                        M O D E L;
MODIFY:                       M O D I F Y;
MONTH:                        M O N T H;
MULTISET:                     M U L T I S E T;
NAME:                         N A M E;
NAN:                          N A N;
NATIONAL:                     N A T I O N A L;
NATIVE:                       N A T I V E;
NATURAL:                      N A T U R A L;
NATURALN:                     N A T U R A L N;
NAV:                          N A V;
NCHAR:                        N C H A R;
NCHAR_CS:                     N C H A R '_' C S;
NCLOB:                        N C L O B;
NESTED:                       N E S T E D;
NESTED_TABLE_ID:              N E S T E D '_' T A B L E '_' I D;
NEW:                          N E W;
NEXT:                         N E X T;
NO:                           N O;
NOAUDIT:                      N O A U D I T;
NOCACHE:                      N O C A C H E;
NOCOMPRESS:                   N O C O M P R E S S;
NOCOPY:                       N O C O P Y;
NOCYCLE:                      N O C Y C L E;
NOENTITYESCAPING:             N O E N T I T Y E S C A P I N G;
NOMAXVALUE:                   N O M A X V A L U E;
NOMINVALUE:                   N O M I N V A L U E;
NONE:                         N O N E;
NOORDER:                      N O O R D E R;
NOSCHEMACHECK:                N O S C H E M A C H E C K;
NOT:                          N O T;
NOWAIT:                       N O W A I T;
NTILE:                        N T I L E;
NULL:                         N U L L;
NULLS:                        N U L L S;
NUMBER:                       N U M B E R;
NUMBER_BASE:                  N U M B E R '_' B A S E;
NUMERIC:                      N U M E R I C;
NVARCHAR2:                    N V A R C H A R '2';
OBJECT:                       O B J E C T;
OCICOLL:                      O C I C O L L;
OCIDATE:                      O C I D A T E;
OCIDATETIME:                  O C I D A T E T I M E;
OCIDURATION:                  O C I D U R A T I O N;
OCIINTERVAL:                  O C I I N T E R V A L;
OCILOBLOCATOR:                O C I L O B L O C A T O R;
OCINUMBER:                    O C I N U M B E R;
OCIRAW:                       O C I R A W;
OCIREF:                       O C I R E F;
OCIREFCURSOR:                 O C I R E F C U R S O R;
OCIROWID:                     O C I R O W I D;
OCISTRING:                    O C I S T R I N G;
OCITYPE:                      O C I T Y P E;
OF:                           O F;
OFF:                          O F F;
OFFLINE:                      O F F L I N E;
OID:                          O I D;
OLD:                          O L D;
ON:                           O N;
ONLINE:                       O N L I N E;
ONLY:                         O N L Y;
OPAQUE:                       O P A Q U E;
OPEN:                         O P E N;
OPERATOR:                     O P E R A T O R;
OPTION:                       O P T I O N;
OR:                           O R;
ORACLE:                       O R A C L E;
ORADATA:                      O R A D A T A;
ORDER:                        O R D E R;
ORDINALITY:                   O R D I N A L I T Y;
ORGANIZATION:                 O R G A N I Z A T I O N;
ORLANY:                       O R L A N Y;
ORLVARY:                      O R L V A R Y;
OSERROR:                      O S E R R O R;
OTHERS:                       O T H E R S;
OUT:                          O U T;
OUTER:                        O U T E R;
OVER:                         O V E R;
OVERLAPS:                     O V E R L A P S;
OVERRIDING:                   O V E R R I D I N G;
PACKAGE:                      P A C K A G E;
PARALLEL_ENABLE:              P A R A L L E L '_' E N A B L E;
PARAMETER:                    P A R A M E T E R;
PARAMETERS:                   P A R A M E T E R S;
PARENT:                       P A R E N T;
PARTITION:                    P A R T I T I O N;
PASCAL:                       P A S C A L;
PASSING:                      P A S S I N G;
PATH:                         P A T H;
PCTFREE:                      P C T F R E E;
PERCENTILE_CONT:              P E R C E N T I L E '_' C O N T;
PERCENTILE_DISC:              P E R C E N T I L E '_' D I S C;
PERCENT_FOUND:                '%' F O U N D;
PERCENT_ISOPEN:               '%' I S O P E N;
PERCENT_NOTFOUND:             '%' N O T F O U N D;
PERCENT_RANK:                 P E R C E N T '_' R A N K;
PERCENT_ROWCOUNT:             '%' R O W C O U N T;
PERCENT_ROWTYPE:              '%' R O W T Y P E;
PERCENT_TYPE:                 '%' T Y P E;
PIPE:                         P I P E;
PIPELINED:                    P I P E L I N E D;
PIVOT:                        P I V O T;
PLAN:                         P L A N;
PLS_INTEGER:                  P L S '_' I N T E G E R;
POSITIVE:                     P O S I T I V E;
POSITIVEN:                    P O S I T I V E N;
PRAGMA:                       P R A G M A;
PRECEDING:                    P R E C E D I N G;
PRECISION:                    P R E C I S I O N;
PREDICTION:                   P R E D I C T I O N;
PREDICTION_BOUNDS:            P R E D I C T I O N '_' B O U N D S;
PREDICTION_COST:              P R E D I C T I O N '_' C O S T;
PREDICTION_DETAILS:           P R E D I C T I O N '_' D E T A I L S;
PREDICTION_PROBABILITY:       P R E D I C T I O N '_' P R O B A B I L I T Y;
PREDICTION_SET:               P R E D I C T I O N '_' S E T;
PRESENT:                      P R E S E N T;
PRIOR:                        P R I O R;
PRIVATE:                      P R I V A T E;
PROCEDURE:                    P R O C E D U R E;
PROMPT:                       P R O M P T;
PUBLIC:                       P U B L I C;
RAISE:                        R A I S E;
RANGE:                        R A N G E;
RANK:                         R A N K;
RATIO_TO_REPORT:              R A T I O '_' T O '_' R  E P O R T;
RAW:                          R A W;
READ:                         R E A D;
REAL:                         R E A L;
RECORD:                       R E C O R D;
REF:                          R E F;
REFERENCE:                    R E F E R E N C E;
REFERENCING:                  R E F E R E N C I N G;
REGR_:                        R E G R '_';
REJECT:                       R E J E C T;
RELIES_ON:                    R E L I E S '_' O N;
REM:                          R E M;
REMAINDER:                    R E M A I N D E R;
RENAME:                       R E N A M E;
REPLACE:                      R E P L A C E;
RESOURCE:                     R E S O U R C E;
RESPECT:                      R E S P E C T;
RESTRICT_REFERENCES:          R E S T R I C T '_' R E F E R E N C E S;
RESULT:                       R E S U L T;
RESULT_CACHE:                 R E S U L T '_' C A C H E;
RETURN:                       R E T U R N;
RETURNING:                    R E T U R N I N G;
REUSE:                        R E U S E;
REVERSE:                      R E V E R S E;
REVOKE:                       R E V O K E;
RIGHT:                        R I G H T;
ROLLBACK:                     R O L L B A C K;
ROLLUP:                       R O L L U P;
ROW:                          R O W;
ROWID:                        R O W I D;
ROWNUM:                       R O W N U M;
ROWS:                         R O W S;
ROW_NUMBER:                   R O W '_' N U M B E R;
RULES:                        R U L E S;
SAMPLE:                       S A M P L E;
SAVE:                         S A V E;
SAVEPOINT:                    S A V E P O I N T;
SB1:                          S B '1';
SB2:                          S B '2';
SB4:                          S B '4';
SCHEMA:                       S C H E M A;
SCHEMACHECK:                  S C H E M A C H E C K;
SCN:                          S C N;
SEARCH:                       S E A R C H;
SECOND:                       S E C O N D;
SEED:                         S E E D;
SEGMENT:                      S E G M E N T;
SELECT:                       S E L E C T;
SELF:                         S E L F;
SEPARATE:                     S E P A R A T E;
SEQUENCE:                     S E Q U E N C E;
SEQUENTIAL:                   S E Q U E N T I A L;
SERIALIZABLE:                 S E R I A L I Z A B L E;
SERIALLY_REUSABLE:            S E R I A L L Y '_' R E U S A B L E;
SERVERERROR:                  S E R V E R E R R O R;
SESSION:                      S E S S I O N;
SESSIONTIMEZONE:              S E S S I O N T I M E Z O N E;
SET:                          S E T;
SETS:                         S E T S;
SETTINGS:                     S E T T I N G S;
SHARE:                        S H A R E;
SHORT:                        S H O R T;
SHOW:                         S H O W;
SHUTDOWN:                     S H U T D O W N;
SIBLINGS:                     S I B L I N G S;
SIGNTYPE:                     S I G N T Y P E;
SIMPLE_INTEGER:               S I M P L E '_' I N T E G E R;
SINGLE:                       S I N G L E;
SIZE:                         S I Z E;
SIZE_T:                       S I Z E '_' T;
SKIP_:                        S K I P; // Alris: added _ (cannot declare a rule with reserved name SKIP)
SMALLINT:                     S M A L L I N T;
SNAPSHOT:                     S N A P S H O T;
SOME:                         S O M E;
SPARSE:                       S P A R S E;
SPECIFICATION:                S P E C I F I C A T I O N;
SQL:                          S Q L;
SQLCODE:                      S Q L C O D E;
SQLDATA:                      S Q L D A T A;
SQLERROR:                     S Q L E R R O R;
SQLNAME:                      S Q L N A M E;
SQLSTATE:                     S Q L S T A T E;
SQL_PERCENT_ROWCOUNT:         S Q L '%' R O W C O U N T;
STANDALONE:                   S T A N D A L O N E;
STANDARD:                     S T A N D A R D;
START:                        S T A R T;
STARTUP:                      S T A R T U P;
STATEMENT:                    S T A T E M E N T;
STATEMENT_ID:                 S T A T E M E N T '_' I D;
STATIC:                       S T A T I C;
STATISTICS:                   S T A T I S T I C S;
STDDEV:                       S T D D E V;
STORED:                       S T O R E D;
STRING:                       S T R I N G;
STRUCT:                       S T R U C T;
STYLE:                        S T Y L E;
SUBMULTISET:                  S U B M U L T I S E T;
SUBPARTITION:                 S U B P A R T I T I O N;
SUBSTITUTABLE:                S U B S T I T U T A B L E;
SUBTYPE:                      S U B T Y P E;
SUCCESS:                      S U C C E S S;
SUCCESSFUL:                   S U C C E S S F U L;
SUM:                          S U M;
SUSPEND:                      S U S P E N D;
SYNONYM:                      S Y N O N Y M;
SYSDATE:                      S Y S D A T E;
TABAUTH:                      T A B A U T H;
TABLE:                        T A B L E;
TDO:                          T D O;
THE:                          T H E;
THEN:                         T H E N;
TIME:                         T I M E;
TIMESTAMP:                    T I M E S T A M P;
TIMESTAMP_LTZ_UNCONSTRAINED:  T I M E S T A M P '_' L T Z '_' U N C O N S T R A I N E D;
TIMESTAMP_TZ_UNCONSTRAINED:   T I M E S T A M P '_' T Z '_' U N C O N S T R A I N E D;
TIMESTAMP_UNCONSTRAINED:      T I M E S T A M P '_' U N C O N S T R A I N E D;
TIMEZONE_ABBR:                T I M E Z O N E '_' A B B R;
TIMEZONE_HOUR:                T I M E Z O N E '_' H O U R;
TIMEZONE_MINUTE:              T I M E Z O N E '_' M I N U T E;
TIMEZONE_REGION:              T I M E Z O N E '_' R E G I O N;
TO:                           T O;
TO_CHAR:                      T O '_' C H A R;
TO_NUMBER:                    T O '_' N U M B E R;
TRAILING:                     T R A I L I N G;
TRANSAC:                      T R A N S A C;
TRANSACTION:                  T R A N S A C T I O N;
TRANSACTIONAL:                T R A N S A C T I O N A L;
TRANSLATE:                    T R A N S L A T E;
TREAT:                        T R E A T;
TRIGGER:                      T R I G G E R;
TRIM:                         T R I M;
TRUE:                         T R U E;
TRUNCATE:                     T R U N C A T E;
TRUSTED:                      T R U S T E D;
TYPE:                         T Y P E;
UB1:                          U B '1';
UB2:                          U B '2';
UB4:                          U B '4';
UID:                          U I D;
UNBOUNDED:                    U N B O U N D E D;
UNDER:                        U N D E R;
UNION:                        U N I O N;
UNIQUE:                       U N I Q U E;
UNLIMITED:                    U N L I M I T E D;
UNPIVOT:                      U N P I V O T;
UNSIGNED:                     U N S I G N E D;
UNTIL:                        U N T I L;
UNTRUSTED:                    U N T R U S T E D;
UPDATE:                       U P D A T E;
UPDATED:                      U P D A T E D;
UPSERT:                       U P S E R T;
UROWID:                       U R O W I D;
USE:                          U S E;
USER:                         U S E R;
USING:                        U S I N G;
VALIDATE:                     V A L I D A T E;
VALIST:                       V A L I S T;
VALUE:                        V A L U E;
VALUES:                       V A L U E S;
VARCHAR2:                     V A R C H A R '2';
VARCHAR:                      V A R C H A R;
VARIABLE:                     V A R I A B L E;
VARIANCE:                     V A R I A N C E;
VARRAY:                       V A R R A Y;
VARYING:                      V A R Y I N G;
VAR_:                         V A R '_';
VERSION:                      V E R S I O N;
VERSIONS:                     V E R S I O N S;
VIEW:                         V I E W;
VIEWS:                        V I E W S;
VOID:                         V O I D;
WAIT:                         W A I T;
WARNING:                      W A R N I N G;
WELLFORMED:                   W E L L F O R M E D;
WHEN:                         W H E N;
WHENEVER:                     W H E N E V E R;
WHERE:                        W H E R E;
WHILE:                        W H I L E;
WITH:                         W I T H;
WITHIN:                       W I T H I N;
WORK:                         W O R K;
WRAPPED:                      W R A P P E D;
WRITE:                        W R I T E;
XML:                          X M L;
XMLAGG:                       X M L A G G;
XMLATTRIBUTES:                X M L A T T R I B U T E S;
XMLCAST:                      X M L C A S T;
XMLCOLATTVAL:                 X M L C O L A T T V A L;
XMLELEMENT:                   X M L E L E M E N T;
XMLEXISTS:                    X M L E X I S T S;
XMLFOREST:                    X M L F O R E S T;
XMLNAMESPACES:                X M L N A M E S P A C E S;
XMLPARSE:                     X M L P A R S E;
XMLPI:                        X M L P I;
XMLQUERY:                     X M L Q U E R Y;
XMLROOT:                      X M L R O O T;
XMLSERIALIZE:                 X M L S E R I A L I Z E;
XMLTABLE:                     X M L T A B L E;
YEAR:                         Y E A R;
YES:                          Y E S;
YMINTERVAL_UNCONSTRAINED:     Y M I N T E R V A L '_' U N C O N S T R A I N E D;
ZONE:                         Z O N E;
